R   1024  720

NO ./textures/test.xpm

SO ./textures/case.xpm

WE ./textures/wood.xpm

EA ./textures/wall_wood.xpm

S ./textures/alien.xpm

F 1, 1, 1

C 255, 255, 255      

11111111111111111111111111111
10000000001100200000000000001
10110000011100000000000010001
1001000000000000E000000010001
10110000011100000000000010001
10000000001100000111011110001
11110111111111011100000010001
11110111111111011101010010001
11000000110101011100002010001
10000000000000001100000010001
10000000000000001101010010001
11000000110101011111011110001
11110111111101011111011110001
11111111111111111111111111111
